R 500 500

NO textures/wood.xpm
SO textures/greystone.xpm
WE textures/mossy.xpm


EA textures/redbrick.xpm

F 220,100,0
C 220,250,50

11111111111111111
10070000000000001
10077077000000111
10000p00100000001
10000000100000001
10000000000000001
11111111111111111
