NO textures/wood.xpm

R 600 400 


SO textures/greystone.xpm
WE textures/mossy.xpm   
EA textures/redbrick.xpm
S textures/barrel.xpm
       
F 160,42,22
C 222,222,22

11111
100001
100001
100N01
11111

