R 500 500

NO textures/wood.xpm
SO textures/greystone.xpm
WE textures/mossy.xpm


EA textures/redbrick.xpm

F 160,48,74
C 220,250,50

1111111111111111111111111111111111
1007000000000000000000000000001
1007000000000000000000011011001
1007000000000107011110000000001
1007000000000000000010000000001
1007000000000000011110000000001
1007707700000010000000000000001
10000p0010000000111111111111111
1000111000100000001
10001 1000000000001
11111 1111111111111
