NO textures/wood.xpm

R 600 400 




SO textures/greystone.xpm
WE textures/mossy.xpm   
EA textures/redbrick.xpm
S textures/barrel.xpm
F 160,48,74
C 254,250,50

 1111111111111111111
 1007000000000000001
 1007000000000000001
 1007000000N00107011
 1007000000000000001
 1007000000000000011
 1007707700000010001
 1000000010000000111
1000001000100000001
1000101000000000001
1111111111111111111
